0605000000000000000
0005000000000000000
0005000000000000000
0005000030000000000
0005000000000000000
0005000000000000000
0005000000000000000
0005555550500000000
0000000000500000000
0000000000555555554
0000000000500000054
0000250000500514054
0000150000500544354
0000000000500555554
0000000000500500000
0000000555500500000
0000000500000500000
0000000505555500000
0000000500000000000
0055555500000000000
5550000000000000000
2010010000000000000
3010410000000000000
4011110000000000000
4000000000000000000
